0 0 0 0 0 0 0 0 0 0 0 0 0 0 0 0 0 0 x
x 0 0 0 0 0 0 0 0 0 0 0 0 0 0 0 0 0 x
x 0 0 0 0 0 0 0 0 0 0 0 0 0 0 0 0 0 x
x 0 0 0 x 0 0 0 x 0 0 0 0 x 0 0 0 0 x
x 0 0 x 0 0 0 x x x 0 0 0 0 x 0 0 0 x
x 0 1 0 0 0 x 0 x 0 x 0 0 0 0 2 0 0 x
x x x x x x x x x x x x x x x x x x x 